0
************
*A---------*
*----------*
*----------*
*---------->
*----------*
*----------*
*---O------*
*----------*
*----------*
*----------*
*********V**_
2
4 11 4 0 1
11 9 0 9 2.
