************
*A_________*
*__________*
*__________*
*__________*
*__________*
*__________*
*__________*
*__________*
*__________*
*__________*
************-
************
*__________*
*__________*
*__________*
*__________*
*__________*
*__________*
*__________*
*__________*
*__________*
*__________*
************-
************
*__________*
*__________*
*__________*
*__________*
*__________*
*__________*
*__________*
*__________*
*__________*
*__________*
************-
************
*__________*
*__________*
*__________*
*__________*
*__________*
*__________*
*__________*
*__________*
*__________*
*__________*
************.