1
************
*----------*
*-----B----*
*----------*
<----------*
*----------*
*----------*
*----------*
*----------*
*----------*
*----------*
****V*******_
2
4 0 4 11 0
11 4 0 4 3.