2
*********^**
*----------*
*----------*
*----------*
*----------*
*----------*
*--C-------*
*----------*
*----------*
*---------->
*----------*
************_
2
0 9 11 9 0
9 11 9 0 3.