3
****^*******
*----------*
*----------*
*-------D--*
*----------*
*----------*
*----------*
*----------*
*----------*
<----------*
*----------*
************_
2
0 4 11 4 1
9 0 9 11 2. 